"filename", "language", "C++", "C", "comment", "blank", "total"
"c:\Users\Tuomas\Documents\PlatformIO\Projects\openATControl\src\U8g2lib.cpp", "C++", 27, 0, 37, 13, 77
"c:\Users\Tuomas\Documents\PlatformIO\Projects\openATControl\src\U8g2lib.h", "C++", 16512, 0, 107, 103, 16722
"c:\Users\Tuomas\Documents\PlatformIO\Projects\openATControl\src\U8x8lib.cpp", "C++", 1276, 0, 295, 303, 1874
"c:\Users\Tuomas\Documents\PlatformIO\Projects\openATControl\src\U8x8lib.h", "C++", 5648, 0, 82, 93, 5823
"c:\Users\Tuomas\Documents\PlatformIO\Projects\openATControl\src\buttonPad.cpp", "C++", 34, 0, 0, 10, 44
"c:\Users\Tuomas\Documents\PlatformIO\Projects\openATControl\src\clib\u8g2.h", "C++", 2896, 0, 240, 157, 3293
"c:\Users\Tuomas\Documents\PlatformIO\Projects\openATControl\src\clib\u8g2_bitmap.c", "C", 0, 146, 41, 32, 219
"c:\Users\Tuomas\Documents\PlatformIO\Projects\openATControl\src\clib\u8g2_box.c", "C", 0, 129, 45, 34, 208
"c:\Users\Tuomas\Documents\PlatformIO\Projects\openATControl\src\clib\u8g2_buffer.c", "C", 0, 120, 65, 29, 214
"c:\Users\Tuomas\Documents\PlatformIO\Projects\openATControl\src\clib\u8g2_circle.c", "C", 0, 331, 68, 81, 480
"c:\Users\Tuomas\Documents\PlatformIO\Projects\openATControl\src\clib\u8g2_cleardisplay.c", "C", 0, 8, 44, 3, 55
"c:\Users\Tuomas\Documents\PlatformIO\Projects\openATControl\src\clib\u8g2_d_memory.c", "C", 0, 1453, 3, 3, 1459
"c:\Users\Tuomas\Documents\PlatformIO\Projects\openATControl\src\clib\u8g2_d_setup.c", "C", 0, 4753, 611, 3, 5367
"c:\Users\Tuomas\Documents\PlatformIO\Projects\openATControl\src\clib\u8g2_font.c", "C", 0, 794, 313, 185, 1292
"c:\Users\Tuomas\Documents\PlatformIO\Projects\openATControl\src\clib\u8g2_fonts.c", "C", 0, 312082, 31495, 2, 343579
"c:\Users\Tuomas\Documents\PlatformIO\Projects\openATControl\src\clib\u8g2_hvline.c", "C", 0, 108, 118, 30, 256
"c:\Users\Tuomas\Documents\PlatformIO\Projects\openATControl\src\clib\u8g2_input_value.c", "C", 0, 82, 51, 18, 151
"c:\Users\Tuomas\Documents\PlatformIO\Projects\openATControl\src\clib\u8g2_intersection.c", "C", 0, 94, 63, 20, 177
"c:\Users\Tuomas\Documents\PlatformIO\Projects\openATControl\src\clib\u8g2_kerning.c", "C", 0, 41, 44, 10, 95
"c:\Users\Tuomas\Documents\PlatformIO\Projects\openATControl\src\clib\u8g2_line.c", "C", 0, 47, 35, 11, 93
"c:\Users\Tuomas\Documents\PlatformIO\Projects\openATControl\src\clib\u8g2_ll_hvline.c", "C", 0, 202, 118, 52, 372
"c:\Users\Tuomas\Documents\PlatformIO\Projects\openATControl\src\clib\u8g2_message.c", "C", 0, 109, 57, 32, 198
"c:\Users\Tuomas\Documents\PlatformIO\Projects\openATControl\src\clib\u8g2_polygon.c", "C", 0, 258, 28, 61, 347
"c:\Users\Tuomas\Documents\PlatformIO\Projects\openATControl\src\clib\u8g2_selection_list.c", "C", 0, 159, 83, 43, 285
"c:\Users\Tuomas\Documents\PlatformIO\Projects\openATControl\src\clib\u8g2_setup.c", "C", 0, 268, 92, 91, 451
"c:\Users\Tuomas\Documents\PlatformIO\Projects\openATControl\src\clib\u8log.c", "C", 0, 167, 67, 27, 261
"c:\Users\Tuomas\Documents\PlatformIO\Projects\openATControl\src\clib\u8log_u8g2.c", "C", 0, 33, 61, 5, 99
"c:\Users\Tuomas\Documents\PlatformIO\Projects\openATControl\src\clib\u8log_u8x8.c", "C", 0, 34, 35, 7, 76
"c:\Users\Tuomas\Documents\PlatformIO\Projects\openATControl\src\clib\u8x8.h", "C++", 653, 0, 350, 195, 1198
"c:\Users\Tuomas\Documents\PlatformIO\Projects\openATControl\src\clib\u8x8_8x8.c", "C", 0, 351, 91, 52, 494
"c:\Users\Tuomas\Documents\PlatformIO\Projects\openATControl\src\clib\u8x8_byte.c", "C", 0, 479, 110, 78, 667
"c:\Users\Tuomas\Documents\PlatformIO\Projects\openATControl\src\clib\u8x8_cad.c", "C", 0, 504, 201, 45, 750
"c:\Users\Tuomas\Documents\PlatformIO\Projects\openATControl\src\clib\u8x8_capture.c", "C", 0, 169, 52, 33, 254
"c:\Users\Tuomas\Documents\PlatformIO\Projects\openATControl\src\clib\u8x8_d_a2printer.c", "C", 0, 100, 57, 25, 182
"c:\Users\Tuomas\Documents\PlatformIO\Projects\openATControl\src\clib\u8x8_d_il3820_296x128.c", "C", 0, 300, 157, 96, 553
"c:\Users\Tuomas\Documents\PlatformIO\Projects\openATControl\src\clib\u8x8_d_ist3020.c", "C", 0, 136, 38, 27, 201
"c:\Users\Tuomas\Documents\PlatformIO\Projects\openATControl\src\clib\u8x8_d_ist7920.c", "C", 0, 134, 40, 29, 203
"c:\Users\Tuomas\Documents\PlatformIO\Projects\openATControl\src\clib\u8x8_d_ks0108.c", "C", 0, 227, 72, 46, 345
"c:\Users\Tuomas\Documents\PlatformIO\Projects\openATControl\src\clib\u8x8_d_lc7981.c", "C", 0, 260, 148, 63, 471
"c:\Users\Tuomas\Documents\PlatformIO\Projects\openATControl\src\clib\u8x8_d_ld7032_60x32.c", "C", 0, 170, 46, 28, 244
"c:\Users\Tuomas\Documents\PlatformIO\Projects\openATControl\src\clib\u8x8_d_ls013b7dh03.c", "C", 0, 134, 43, 21, 198
"c:\Users\Tuomas\Documents\PlatformIO\Projects\openATControl\src\clib\u8x8_d_max7219.c", "C", 0, 294, 64, 47, 405
"c:\Users\Tuomas\Documents\PlatformIO\Projects\openATControl\src\clib\u8x8_d_pcd8544_84x48.c", "C", 0, 108, 37, 22, 167
"c:\Users\Tuomas\Documents\PlatformIO\Projects\openATControl\src\clib\u8x8_d_pcf8812.c", "C", 0, 105, 65, 24, 194
"c:\Users\Tuomas\Documents\PlatformIO\Projects\openATControl\src\clib\u8x8_d_pcf8814_hx1230.c", "C", 0, 130, 44, 25, 199
"c:\Users\Tuomas\Documents\PlatformIO\Projects\openATControl\src\clib\u8x8_d_sbn1661.c", "C", 0, 135, 47, 36, 218
"c:\Users\Tuomas\Documents\PlatformIO\Projects\openATControl\src\clib\u8x8_d_sed1330.c", "C", 0, 231, 67, 54, 352
"c:\Users\Tuomas\Documents\PlatformIO\Projects\openATControl\src\clib\u8x8_d_sh1106_64x32.c", "C", 0, 142, 48, 26, 216
"c:\Users\Tuomas\Documents\PlatformIO\Projects\openATControl\src\clib\u8x8_d_sh1106_72x40.c", "C", 0, 142, 49, 26, 217
"c:\Users\Tuomas\Documents\PlatformIO\Projects\openATControl\src\clib\u8x8_d_sh1107.c", "C", 0, 338, 90, 74, 502
"c:\Users\Tuomas\Documents\PlatformIO\Projects\openATControl\src\clib\u8x8_d_sh1108.c", "C", 0, 141, 55, 30, 226
"c:\Users\Tuomas\Documents\PlatformIO\Projects\openATControl\src\clib\u8x8_d_sh1122.c", "C", 0, 165, 87, 36, 288
"c:\Users\Tuomas\Documents\PlatformIO\Projects\openATControl\src\clib\u8x8_d_ssd1305.c", "C", 0, 269, 60, 61, 390
"c:\Users\Tuomas\Documents\PlatformIO\Projects\openATControl\src\clib\u8x8_d_ssd1306_128x32.c", "C", 0, 169, 53, 31, 253
"c:\Users\Tuomas\Documents\PlatformIO\Projects\openATControl\src\clib\u8x8_d_ssd1306_128x64_noname.c", "C", 0, 315, 76, 75, 466
"c:\Users\Tuomas\Documents\PlatformIO\Projects\openATControl\src\clib\u8x8_d_ssd1306_48x64.c", "C", 0, 144, 52, 20, 216
"c:\Users\Tuomas\Documents\PlatformIO\Projects\openATControl\src\clib\u8x8_d_ssd1306_64x32.c", "C", 0, 175, 49, 35, 259
"c:\Users\Tuomas\Documents\PlatformIO\Projects\openATControl\src\clib\u8x8_d_ssd1306_64x48.c", "C", 0, 139, 48, 27, 214
"c:\Users\Tuomas\Documents\PlatformIO\Projects\openATControl\src\clib\u8x8_d_ssd1306_72x40.c", "C", 0, 140, 98, 29, 267
"c:\Users\Tuomas\Documents\PlatformIO\Projects\openATControl\src\clib\u8x8_d_ssd1306_96x16.c", "C", 0, 139, 48, 27, 214
"c:\Users\Tuomas\Documents\PlatformIO\Projects\openATControl\src\clib\u8x8_d_ssd1309.c", "C", 0, 191, 55, 43, 289
"c:\Users\Tuomas\Documents\PlatformIO\Projects\openATControl\src\clib\u8x8_d_ssd1316.c", "C", 0, 140, 59, 38, 237
"c:\Users\Tuomas\Documents\PlatformIO\Projects\openATControl\src\clib\u8x8_d_ssd1317.c", "C", 0, 143, 64, 35, 242
"c:\Users\Tuomas\Documents\PlatformIO\Projects\openATControl\src\clib\u8x8_d_ssd1318.c", "C", 0, 181, 78, 59, 318
"c:\Users\Tuomas\Documents\PlatformIO\Projects\openATControl\src\clib\u8x8_d_ssd1322.c", "C", 0, 358, 101, 75, 534
"c:\Users\Tuomas\Documents\PlatformIO\Projects\openATControl\src\clib\u8x8_d_ssd1325.c", "C", 0, 299, 80, 57, 436
"c:\Users\Tuomas\Documents\PlatformIO\Projects\openATControl\src\clib\u8x8_d_ssd1326.c", "C", 0, 175, 60, 43, 278
"c:\Users\Tuomas\Documents\PlatformIO\Projects\openATControl\src\clib\u8x8_d_ssd1327.c", "C", 0, 587, 214, 152, 953
"c:\Users\Tuomas\Documents\PlatformIO\Projects\openATControl\src\clib\u8x8_d_ssd1329.c", "C", 0, 207, 49, 43, 299
"c:\Users\Tuomas\Documents\PlatformIO\Projects\openATControl\src\clib\u8x8_d_ssd1606_172x72.c", "C", 0, 204, 128, 63, 395
"c:\Users\Tuomas\Documents\PlatformIO\Projects\openATControl\src\clib\u8x8_d_ssd1607_200x200.c", "C", 0, 410, 187, 122, 719
"c:\Users\Tuomas\Documents\PlatformIO\Projects\openATControl\src\clib\u8x8_d_st7511.c", "C", 0, 135, 51, 29, 215
"c:\Users\Tuomas\Documents\PlatformIO\Projects\openATControl\src\clib\u8x8_d_st75256.c", "C", 0, 1256, 209, 312, 1777
"c:\Users\Tuomas\Documents\PlatformIO\Projects\openATControl\src\clib\u8x8_d_st7528.c", "C", 0, 189, 81, 44, 314
"c:\Users\Tuomas\Documents\PlatformIO\Projects\openATControl\src\clib\u8x8_d_st75320.c", "C", 0, 174, 59, 39, 272
"c:\Users\Tuomas\Documents\PlatformIO\Projects\openATControl\src\clib\u8x8_d_st7565.c", "C", 0, 873, 171, 182, 1226
"c:\Users\Tuomas\Documents\PlatformIO\Projects\openATControl\src\clib\u8x8_d_st7567.c", "C", 0, 656, 93, 111, 860
"c:\Users\Tuomas\Documents\PlatformIO\Projects\openATControl\src\clib\u8x8_d_st7586s_erc240160.c", "C", 0, 185, 40, 32, 257
"c:\Users\Tuomas\Documents\PlatformIO\Projects\openATControl\src\clib\u8x8_d_st7586s_s028hn118a.c", "C", 0, 181, 35, 31, 247
"c:\Users\Tuomas\Documents\PlatformIO\Projects\openATControl\src\clib\u8x8_d_st7588.c", "C", 0, 155, 57, 45, 257
"c:\Users\Tuomas\Documents\PlatformIO\Projects\openATControl\src\clib\u8x8_d_st7920.c", "C", 0, 144, 61, 31, 236
"c:\Users\Tuomas\Documents\PlatformIO\Projects\openATControl\src\clib\u8x8_d_t6963.c", "C", 0, 347, 155, 62, 564
"c:\Users\Tuomas\Documents\PlatformIO\Projects\openATControl\src\clib\u8x8_d_uc1601.c", "C", 0, 126, 39, 24, 189
"c:\Users\Tuomas\Documents\PlatformIO\Projects\openATControl\src\clib\u8x8_d_uc1604.c", "C", 0, 146, 59, 36, 241
"c:\Users\Tuomas\Documents\PlatformIO\Projects\openATControl\src\clib\u8x8_d_uc1608.c", "C", 0, 261, 69, 64, 394
"c:\Users\Tuomas\Documents\PlatformIO\Projects\openATControl\src\clib\u8x8_d_uc1610.c", "C", 0, 158, 103, 44, 305
"c:\Users\Tuomas\Documents\PlatformIO\Projects\openATControl\src\clib\u8x8_d_uc1611.c", "C", 0, 446, 118, 70, 634
"c:\Users\Tuomas\Documents\PlatformIO\Projects\openATControl\src\clib\u8x8_d_uc1617.c", "C", 0, 165, 44, 33, 242
"c:\Users\Tuomas\Documents\PlatformIO\Projects\openATControl\src\clib\u8x8_d_uc1638.c", "C", 0, 140, 51, 33, 224
"c:\Users\Tuomas\Documents\PlatformIO\Projects\openATControl\src\clib\u8x8_d_uc1701_dogs102.c", "C", 0, 137, 43, 24, 204
"c:\Users\Tuomas\Documents\PlatformIO\Projects\openATControl\src\clib\u8x8_d_uc1701_mini12864.c", "C", 0, 139, 43, 24, 206
"c:\Users\Tuomas\Documents\PlatformIO\Projects\openATControl\src\clib\u8x8_debounce.c", "C", 0, 111, 76, 19, 206
"c:\Users\Tuomas\Documents\PlatformIO\Projects\openATControl\src\clib\u8x8_display.c", "C", 0, 88, 56, 21, 165
"c:\Users\Tuomas\Documents\PlatformIO\Projects\openATControl\src\clib\u8x8_fonts.c", "C", 0, 19043, 789, 2, 19834
"c:\Users\Tuomas\Documents\PlatformIO\Projects\openATControl\src\clib\u8x8_gpio.c", "C", 0, 5, 40, 5, 50
"c:\Users\Tuomas\Documents\PlatformIO\Projects\openATControl\src\clib\u8x8_input_value.c", "C", 0, 70, 44, 10, 124
"c:\Users\Tuomas\Documents\PlatformIO\Projects\openATControl\src\clib\u8x8_message.c", "C", 0, 87, 47, 19, 153
"c:\Users\Tuomas\Documents\PlatformIO\Projects\openATControl\src\clib\u8x8_selection_list.c", "C", 0, 100, 53, 21, 174
"c:\Users\Tuomas\Documents\PlatformIO\Projects\openATControl\src\clib\u8x8_setup.c", "C", 0, 69, 62, 17, 148
"c:\Users\Tuomas\Documents\PlatformIO\Projects\openATControl\src\clib\u8x8_string.c", "C", 0, 98, 60, 13, 171
"c:\Users\Tuomas\Documents\PlatformIO\Projects\openATControl\src\clib\u8x8_u16toa.c", "C", 0, 36, 36, 5, 77
"c:\Users\Tuomas\Documents\PlatformIO\Projects\openATControl\src\clib\u8x8_u8toa.c", "C", 0, 27, 35, 6, 68
"c:\Users\Tuomas\Documents\PlatformIO\Projects\openATControl\src\core.cpp", "C++", 177, 0, 43, 34, 254
"c:\Users\Tuomas\Documents\PlatformIO\Projects\openATControl\src\main.cpp", "C++", 59, 0, 1, 24, 84
"c:\Users\Tuomas\Documents\PlatformIO\Projects\openATControl\src\mapHandler.cpp", "C++", 616, 0, 67, 79, 762
"c:\Users\Tuomas\Documents\PlatformIO\Projects\openATControl\src\screenControl.cpp", "C++", 178, 0, 5, 37, 220
"c:\Users\Tuomas\Documents\PlatformIO\Projects\openATControl\src\speedMeasurement.cpp", "C++", 39, 0, 1, 9, 49
"c:\Users\Tuomas\Documents\PlatformIO\Projects\openATControl\src\storageHandler.cpp", "C++", 7, 0, 0, 10, 17
"c:\Users\Tuomas\Documents\PlatformIO\Projects\openATControl\src\ui.cpp", "C++", 568, 0, 54, 122, 744
"Total", "-", 28690, 356445, 40965, 5354, 431454